████████████
████████████
█ █         
█ █ █████ █ 
█   █   █ █ 
█████ █ ███ 
█   █ █   █ 
█ █ █ ███ █ 
█ █   █ █P█ 
█ █████ ███ 
█           
██E█████████
